агентство: агентство
адрес: адреса
аналогичный: аналогичной
анонс: анонсов
аудитория: аудитории, аудиторий
баландин: баландин
блогер: блоггеров
бояться: бояться
ваш: вашему
ведомость: ведомостях
вернуться: вернуться
версия: версию
включить: включен
вовсе: вовсе
возможно: возможно
возможность: возможность
вопрос: вопросом, вопросы, вопрос
вроде: вроде
встреча: встречу
выбрать: выбрал
высокий: высоких
главный: главную
голос: голосов
готовый: готовых
группа: группы
далее: д
движок: движок
дзен: дзен
добавить: добавить
должный: должен
достаточно: достаточно
доступ: доступ
доступный: доступных
думать: думаете
журналист: журналистами
забыть: забудем
задавать: задаваемые
закладка: закладки
закрытый: закрыт
знать: знаем, знаю
идеально: идеально
идея: идея, идею
индиец: индийцев
интересно: интересно
интересовать: интересует
интернет: интернет
использовать: использовать
история: истории
июл: июл
карма: карма
карьера: карьера
количество: количество
коллективный: коллективного, коллективным
колонка: колонках
коментарий: коментариев
комментарий: комментариев, комментарии
конкретный: конкретному
который: которым
круто: круто
латиноамериканец: латиноамериканцы
логин: логине
маслов: маслов
меню: меню
местный: местном
мина: мин
найти: найдена
наполнение: наполнение
насколько: насколько
настройка: настройка
недоделка: недоделок
неожиданный: неожиданная
неработающий: неработающих
несколько: нескольких
несмотря: несмотря
неуютный: неуютно
неформальный: неформальную
новый: новых
о: обо
обновить: обновить
обращаться: обращаюсь
один: одному
опубликовать: опубликована
основное: основном
остаться: останутся
ответ: ответов
отличаться: отличаются
отсутствовать: отсутствующих
ошибка: ошибки
ощущение: ощущение
павел: павел
партнёр: партнеры
первый: первой
пиарить: пиарят
писать: пишите, писать
планировать: планируем
поддержка: поддержка
подкаст: подкасты
подходить: подходит
поиск: поиск
получаться: получается
получиться: получилось
пользователь: пользователь, пользователей
пользоваться: пользуется, пользуются
пометка: пометки
популярность: популярность
популярный: популярными, популярен
посему: посему
поскольку: поскольку
пост: постов
похожий: похожие
предложениекомментарий: предложениекомментарии
привет: привет
принцип: принципе
провести: провели
происходить: происходит
просмотр: просмотров
просмотреть: просмотренной
протокол: протоколом
профиль: профиль
прочтение: прочтение
публикация: публикации
публиковать: публиковать
равно: равно
раздел: раздел
разлогинивание: разлогинивание
разобраться: разберемся
рамблер: рамблер
ранее: ранее
реализовать: реализовано
региональный: региональных
редактирование: редактирование
рейтинг: рейтинг
ресурс: ресурсы, ресурсов
решить: решили
российский: российских
россия: россии
русскоязычный: русскоязычные
рынок: рынке
сайт: сайта, сайт, сайте, сайту
самопроизвольно: самопроизвольно
самопроизвольный: самопроизвольное
сборник: сборника
сделать: сделать
сервис: сервис
система: системой
сказать: скажу
следующий: следующим
смена: смене
смысл: смысла
создаваться: создавался
сокура: сокур
сопровождение: сопровождения
составление: составления
социальный: социальные
среди: среди
ссср: ссср
ссылка: ссылку
становиться: становится, становились
старый: старую
статья: статья
страна: странах
страница: странице, страница, страниц
страшилка: страшилка
сутки: сутки
существовать: существовала
такой: такого
тег: теги
текст: тексты
телефония: телефонии
тема: тему
технический: техническая
технология: технологий
титов: титов
трансляция: трансляции
трудно: трудно
трудный: трудный
уверенный: уверен
удаление: удаление
удалить: удалена, удалить
устареть: устарела
хаба: хабы
хабра: хабр
хабрахабра: хабрахабра, хабрахабр, хабрахабре
хм: хм
хороший: хорошая, хороших, лучшие
чаво: чаво
чекбокс: чекбокс
человек: людей, человеку
читатель: читателям
чулан: чулан
экс: экс
юрий: юрий
язык: языка, язык
яндекс: яндекс
