похожий:  похожие
июл:  июл
хороший:  лучшие
комментарий:  комментарии
профиль:  профиль
история:  истории
выбрать:  выбрал
провести:  провели
дзен:  дзен
старый:  старую
карьера:  карьера
неформальный:  неформальную
маслов:  маслов
язык:  язык языка
мина:  мин
должный:  должен
прочтение:  прочтение
меню:  меню
поддержка:  поддержка
технический:  техническая
чулан:  чулан
голос:  голосов
насколько:  насколько
настройка:  настройка
рамблер:  рамблер
версия:  версию
рейтинг:  рейтинг
количество:  количество
журналист:  журналистами
местный:  местном
хаба:  хабы
сайт:  сайт
бояться:  бояться
ведомость:  ведомостях
партнёр:  партнеры
сутки:  сутки
вернуться:  вернуться
опубликовать:  опубликована
добавить:  добавить
поиск:  поиск
просмотр:  просмотров
яндекс:  яндекс
рынок:  рынке
встреча:  встречу
хабра:  хабр
знать:  знаю
агентство:  агентство
публикация:  публикации
карма:  карма
пиарить:  пиарят
закладка:  закладки
россия:  россии
обновить:  обновить
тег:  теги
сокура:  сокур
