брендировать:  брендировали
комментарий:  комментарии
профиль:  профиль
дзен:  дзен
меню:  меню
прочтение:  прочтение
эпизод:  эпизод
поддержка:  поддержка
версия:  версию
рейтинг:  рейтинг
хаба:  хабы
окно:  окне
дмитрий:  дмитрий
сутки:  сутки
вернуться:  вернуться
серия:  серии
поиск:  поиск
закладка:  закладки
обновить:  обновить
интересный:  интересный
наш:  нашем
пропустить:  пропустил пропущенный
хороший:  лучшие
поллучиться:  поллучился
история:  истории
старый:  старую
язык:  язык языка
понравиться:  понравилось
гугл:  гугл
совместно:  совместно
коварный:  коварных
карта:  карта карту
количество:  количество
клан:  кланов
ждать:  жду
проект:  проект
преступление:  преступлений
вылезать:  вылезает
хабра:  хабр
лежать:  лежала
идея:  идея
место:  местах местам
местный:  местным
пытаться:  пытаться
июл:  июл
мера:  мере
успеть:  успел
первый:  первым первыми
мафиозный:  мафиозных
пример:  примером
нужный:  нужна
пользователь:  пользователь
просмотр:  просмотров
обидеть:  обидели
яндекс:  яндекс
рынок:  рынке
публикация:  публикации
придумать:  придумали
тег:  теги
кликать:  кликаешь
сериал:  сериал
похожий:  похожие
крайний:  крайней
бренд:  брендам
ссылка:  ссылок
применять:  применять
мина:  мин
серчинга:  серчинг
ошибиться:  ошибусь
технический:  техническая
чулан:  чулан
заметный:  заметным
настройка:  настройка
убить:  убили
добавить:  добавить
носитель:  носитель
мощь:  мощь
вопрос:  вопрос
специалист:  специалистам
сказать:  скажу
ульянов:  ульянов
поверхность:  поверхности
возможно:  возможно
пометить:  помечена
карма:  карма
