похожий:  похожие
июл:  июл
хороший:  лучшие
комментарий:  комментарии комментариев
профиль:  профиль
история:  истории
дзен:  дзен
старый:  старую
язык:  язык языка
мина:  мин
меню:  меню
прочтение:  прочтение
поддержка:  поддержка
технический:  техническая
голос:  голосов
настройка:  настройка
версия:  версию
рейтинг:  рейтинг
количество:  количество
хаба:  хабы
сутки:  сутки
константин:  константин
вернуться:  вернуться
добавить:  добавить
поиск:  поиск
просмотр:  просмотров
яндекс:  яндекс
рощупкина:  рощупкин
хабра:  хабр
публикация:  публикации
карма:  карма
закладка:  закладки
тег:  теги
обновить:  обновить
кнопка:  кнопка
