проверить:  проверить
комментарий:  комментарии
профиль:  профиль
дзен:  дзен
отсутствие:  отсутствие
первый:  первую первой
глаз:  глаза
оказаться:  оказалось
видеть:  видим
меню:  меню
прочтение:  прочтение
поддержка:  поддержка
голос:  голосов
версия:  версию
популярность:  популярность популярности
использовать:  используя
характеризовать:  характеризовать
подручный:  подручными
рейтинг:  рейтинг
авг:  авг
хаба:  хабы
дмитрий:  дмитрий
порно:  порно
броситься:  бросилось
получить:  получил
простой:  проще
региональный:  региональная региональной
следующий:  следующая следующую
сутки:  сутки
вернуться:  вернуться
посмотреть:  посмотрев
поиск:  поиск
исследование:  исследование
волгоград:  волгоград
нижний:  нижний
рост:  рост роста
провести:  проведя
население:  населения
активность:  активность
закладка:  закладки
обновить:  обновить
попасть:  попали
совпасть:  совпали
уфа:  уфа
попугай:  попугаи
выкладка:  выкладке
хороший:  лучшие
история:  истории
украина:  украины
случайно:  случайно
старый:  старую
пихтый:  пихто
несложный:  несложные
язык:  язык языка
новгород:  новгород
таблица:  таблицу таблицы
количество:  количество количеством
средство:  средствами
чисто:  чисто
гугл:  гугла
рунет:  рунета
минус:  минус
непривычно:  непривычно
интернет:  интернете
хабра:  хабр
незамысловатый:  незамысловатым
выборка:  выборку
начинающий:  начинающие
картина:  картину
казань:  казань
гипотеза:  гипотеза
связь:  связь
сортировка:  сортировку
яндекс:  яндексе яндекс яндекса
индикатор:  индикатор
город:  городах город города
ввести:  введя
статистический:  статистическое
искать:  ищет
горячий:  горячих
краснодар:  краснодар
владивосток:  владивосток
пользователь:  пользователь пользователи
просмотр:  просмотров
странный:  странное
способ:  способом
иркутск:  иркутск
публикация:  публикации
тег:  теги
получиться:  получилось
похожий:  похожие похожую
арифметический:  арифметические
тренд:  тренд
мина:  мин
технический:  техническая
чулан:  чулан
действие:  действия
красноярск:  красноярск
такой:  таким
настройка:  настройка
семь:  семи
возникнуть:  возникла
увидеть:  увидел
ставрополь:  ставрополь
столица:  столиц
добавить:  добавить
активный:  активный
зона:  зон
беларусь:  беларуси
наверное:  наверное
карма:  карма
происходить:  происходит
сразу:  сразу
остаться:  оставшихся
точка:  точек
