брайан:  брайан
комментарий:  комментарии
профиль:  профиль
дзен:  дзен
исполнительный:  исполнительный
сайт:  сайте
случай:  случай
карта:  карты
меню:  меню
прочтение:  прочтение
поддержка:  поддержка
содержимое:  содержимое
голос:  голосов
сообщество:  сообщества сообщество
версия:  версию
шустрый:  шустер
такой:  такую такого
рейтинг:  рейтинг
хаба:  хабы
ввести:  ввести
сеть:  сети
прочитать:  прочитал
сообщение:  сообщений
открыть:  открыл
эротический:  эротической эротическими
сутки:  сутки
вернуться:  вернуться
поиск:  поиск
директор:  директор
правило:  правилах
сервис:  сервиса
закладка:  закладки
надеяться:  надеется
обновить:  обновить
компания:  компания
конец:  концу
запись:  запись
хороший:  лучшие
история:  истории
сотрудник:  сотрудники
старый:  старую
род:  рода
успех:  успех
язык:  язык языка
намерить:  намерена
отслеживать:  отслеживать
мой:  моему
новость:  новость
количество:  количество
фото:  фото
сетевой:  сетевое
потребоваться:  потребуется
хабра:  хабр
пользователь:  пользователей пользователь
повторить:  повторить
оператор:  оператор
вход:  вход
разрешить:  разрешен
ваховский:  ваховский
июл:  июл
предмет:  предмет
подростковый:  подросткового
миллион:  миллиона
социальный:  социальной
запретить:  запрещен
взрослый:  взрослый взрослых
источник:  источник
кредитный:  кредитной
свой:  своем
просмотр:  просмотров
яндекс:  яндекс
видеоигра:  видеоигры
публикация:  публикации
тег:  теги
гаразды:  гаразд
обмен:  обмен
фантазия:  фантазий
специальный:  специальные
похожий:  похожие
номер:  номер
мина:  мин
регистрация:  регистрации
технический:  техническая
чулан:  чулан
привлечь:  привлечь
настройка:  настройка
клинический:  клинический
добавить:  добавить
даниил:  даниил
карма:  карма
несовершеннолетний:  несовершеннолетних
лицо:  лицам
