ответ:  ответ
владислав:  владислава владислав
остальной:  остальные
комментарий:  комментарии
профиль:  профиль
эффективность:  эффективность
дзен:  дзен
публиковать:  публикую
оживить:  оживить
карьера:  карьера
меню:  меню
прочтение:  прочтение
дорого:  дорого
поддержка:  поддержка
голос:  голосов
улендеев:  улендеева улендеев
насколько:  насколько
версия:  версию
ссылка:  ссылке
рейтинг:  рейтинг
использовать:  использует
хаба:  хабы
цент:  цента
весь:  всей
сутки:  сутки
вернуться:  вернуться
гугл:  гугле
правый:  правы
реальный:  реальных
итак:  итак
ответить:  ответил
поиск:  поиск
посетитель:  посетителя
работа:  работы
сидеть:  сидят
кликать:  кликают
закладка:  закладки
обновить:  обновить
верно:  верно
хороший:  лучшие
история:  истории
получать:  получаем
старый:  старую
мощь:  мощи
язык:  язык языка
трафик:  трафике трафик
искать:  искать
интервью:  интервью
спросить:  спросил
количество:  количество
никакой:  никаких
сайт:  сайт
холдинг:  холдинга
утверждение:  утверждение
коммерциявладислав:  коммерциявладислав
маркет:  маркете маркетом
уметь:  умею умеем
буквально:  буквально
камень:  камней
хабра:  хабр
поисковик:  поисковиков поисковиках
точность:  точностью
июл:  июл
простой:  прост
группа:  группу
активно:  активно
яндекс:  яндексе яндекс
рекламироваться:  рекламируемся рекламироваться
электронный:  электронная
исполнительный:  исполнительного
участвовать:  участвует
источник:  источник
результат:  результат
просмотр:  просмотров
пробовать:  пробовали
каждый:  каждого
реклама:  рекламы реклама
публикация:  публикации
директор:  директора
считать:  считать
тег:  теги
похожий:  похожие
мина:  мин
эффективный:  эффективна
улендеевэффективностьтрафить:  улендеевэффективностьтрафи
технический:  техническая
практически:  практически
чулан:  чулан
эффективно:  эффективно
настройка:  настройка
покупатель:  покупателей
робот:  роботов
добавить:  добавить
причина:  причин
войти:  вошел
карма:  карма
плачевный:  плачевный
подводный:  подводных
