контекстный:  контекстной
изнутри:  изнутри
купить:  купит
креатив:  креативе
комментарий:  комментарии
профиль:  профиль
эффективность:  эффективность
подтверждать:  подтверждает
дзен:  дзен
подробно:  подробно
наблюдение:  наблюдение
интернет:  интернет
статья:  статья статье статьи
уверить:  уверены
меню:  меню
прочтение:  прочтение
культура:  культуры
поддержка:  поддержка
скорее:  скорее
совпасть:  совпадет
версия:  версию
рейтинг:  рейтинг
хаба:  хабы
сеть:  сети
дмитрий:  дмитрий
сутки:  сутки
понятный:  понятные
вернуться:  вернуться
невозможно:  невозможно
функционал:  функционала
создать:  создать
поиск:  поиск поиска
максимум:  максимум
мегабеглый:  мегабеглый
данный:  данный
кликнуть:  кликнут
реклама:  рекламой рекламы реклама
закладка:  закладки
рассказ:  рассказ
обновить:  обновить
рекламодатель:  рекламодатели
стать:  статей
бренд:  брендов
мозг:  мозг
воздействие:  воздействии
таргетирование:  таргетирование
источник:  источников
который:  которое
сказать:  сказанное
хороший:  лучшие
история:  истории
поэтому:  поэтому
старый:  старую
успех:  успех
подход:  подходы
писать:  писать
язык:  язык языка
эффективный:  эффективное эффективной
тв:  тв
знание:  знания
интеграция:  интеграции
офлайн:  оффлайн
хотеться:  хочется
коммуникация:  коммуникация
количество:  количество
обзор:  обзор
тема:  тему темой
момент:  момент
прятать:  прятать
маркетинг:  маркетинге маркетинга
умничанье:  умничанья
разрабатывать:  разрабатывать
интересный:  интересную
всяческий:  всяческий
креативный:  креативного
последний:  последних
авторитетный:  авторитетных
указание:  указанием
каждый:  каждой
знать:  знают
информация:  информацию
рекламист:  рекламисты
хабра:  хабр
прямой:  прямой
основной:  основные
тренд:  тренды
включая:  включая
взгляд:  взгляды взгляд
положение:  положения
июл:  июл
краткий:  краткий
копирайт:  копирайте
узкий:  узкая
правильный:  правильные правильное
баннер:  баннер
пассивный:  пассивное
сообщение:  сообщение
онлайновый:  онлайновые
собственный:  собственным
проглотить:  проглотить
пользователь:  пользователь пользователи
просмотр:  просмотров
яндекс:  яндекс
желание:  желание
отсутствие:  отсутствия
крейн:  крейном
вопрос:  вопросом
комментировать:  комментировать
публикация:  публикации
зритель:  зритель
директор:  директора
сёрфер:  серфер
необходимость:  необходимость
тег:  теги
идеально:  идеально
похожий:  похожие
кампания:  кампании
посыл:  посыл
таргетировать:  таргетированная
мина:  мин
технический:  техническая
связать:  связано
чулан:  чулан
мощный:  мощного
настройка:  настройка
изучать:  изучают
изменить:  изменить
простой:  простые
призвать:  призвано
добавить:  добавить
активный:  активный
прочесть:  прочесть
фокусировка:  фокусировок
ульянов:  ульянов
карма:  карма
