молодёжный:  молодежных молодежной
отобрать:  отобранных
шоу:  шоу
тренд:  трендов тренда
комментарий:  комментарии
профиль:  профиль
доля:  доля
маркетинговый:  маркетинговых
дзен:  дзен
помнить:  помните
море:  моря
скоро:  скоро
интернет:  интернет
аккаунт:  аккаунт аккаунты
заключать:  заключает
основное:  основном
статья:  статью статьи
меню:  меню
прочтение:  прочтение
поддержка:  поддержка
вылезать:  вылезают
коммуникация:  коммуникаций
общение:  общения
версия:  версию
карибский:  карибского
рейтинг:  рейтинг
френд:  френдами френдов
тинэйджер:  тинэйджерами
хаба:  хабы
сеть:  сети сетей сетями
бизнес:  бизнеса
дмитрий:  дмитрий
счёт:  счет
потребительский:  потребительского
сутки:  сутки
первый:  первое
вернуться:  вернуться
блогер:  блоггеры
сша:  сша
аудитоия:  аудитоий
поиск:  поиск
наравне:  наравне
июль:  июля
пять:  пяти
необходимый:  необходимым
шутка:  шутка
данные:  данным
скрупулёзно:  скрупулезно
сфера:  сферам
создавать:  создают
социальный:  социальными социальных социальные
планета:  планете планеты
закладка:  закладки
обновить:  обновить
студия:  студии
частый:  частые
знание:  знаниям
стать:  статей станет
сайт:  сайта сайтов
промоутировать:  промоутируя
владелец:  владельцы
затрагивать:  затрагивают затрагивающих
другой:  другим
аудитория:  аудитории
хороший:  лучшие
номер:  номера
реклама:  рекламе рекламы
история:  истории
выпускать:  выпускает
фокусировка:  фокусировки
продукт:  продукте
старый:  старую
старший:  старше
пират:  пиратов
посредством:  посредством
услуга:  услуги
язык:  язык языка
привлекать:  привлекает
телевизионный:  телевизионные
издание:  издание
занимать:  занимает
третий:  третье
количество:  количество
обзор:  обзор
тема:  тему
пресса:  прессы
приготовиться:  приготовьтесь
важный:  важную
доступ:  доступ
приводить:  приводит
газета:  газет газетой
предложить:  предложить
каждый:  каждой
вместо:  вместо
посещаемость:  посещаемости
поведение:  поведения
консалтинговый:  консалтинговые
хабра:  хабр
пользователь:  пользователей пользователь пользователи
прямой:  прямой
успешно:  успешно
к:  ко
сомнительный:  сомнительной
пример:  примере примеры
делать:  делает
личный:  личные
наугад:  наугад
продюсер:  продюсеры
поздний:  поздние
июл:  июл
крейн:  крейна
высокий:  высокая
музыкальный:  музыкальные
занятой:  занятые
устраивать:  устраивают
миллион:  миллиона
пользоваться:  пользуются
молодой:  молодыми
самовыражение:  самовыражения
кастинг:  кастинги
исследование:  исследованиями
главное:  главное
дежавю:  дежавю
рука:  руках
мелкий:  мелкого
эффективность:  эффективности
рекламный:  рекламной
двадцать:  двадцати
отставать:  отставать
просмотр:  просмотров
сиквел:  сиквела
сериал:  сериалов
яндекс:  яндекс
интерес:  интересам
клуб:  клубов
иначе:  иначе
вообще:  вообще
художник:  художники
публикация:  публикации
ресторан:  ресторанов
бесплатный:  бесплатный
собственный:  собственного
директор:  директора
тег:  теги
человек:  людей
взрослый:  взрослых
вывод:  вывод
таргетированность:  таргетированность
тред:  треде
кампания:  кампании
похожий:  похожие
дизайнер:  дизайнеры
жаждать:  жаждущие
занятие:  занятия
продвигать:  продвигают
одновременно:  одновременно
мина:  мин
социализироваться:  социализирующиеся
технический:  техническая
чулан:  чулан
основный:  основных
автор:  автор
настройка:  настройка
переводить:  переводить
среди:  среди
монстр:  монстр
тридцать:  тридцати
девяностый:  девяностые
решить:  решил
взрослеть:  взрослеет
который:  которым
добавить:  добавить
компания:  компании
запоздалый:  запоздалые
неизбежный:  неизбежном
печатать:  печатали
подросток:  подростки
оказываться:  оказывается
шестой:  шестое
следствие:  следствие
рэнс:  рэнса
специалист:  специалисты
смежный:  смежным
ульянов:  ульянов
карма:  карма
больший:  большую
упаковка:  упаковке
место:  место
следующий:  следующем
