похожий:  похожие
июл:  июл
трансляция:  трансляции
хороший:  лучшие хорошая хороших
комментарий:  комментарии
профиль:  профиль
готовый:  готовых
история:  истории
дзен:  дзен
первый:  первой
старый:  старую
достаточно:  достаточно
карьера:  карьера
язык:  язык языка
думать:  думаете
мина:  мин
меню:  меню
прочтение:  прочтение
поддержка:  поддержка
технический:  техническая
наполнение:  наполнение
голос:  голосов
настройка:  настройка
версия:  версию
рейтинг:  рейтинг
раздел:  раздел
количество:  количество
коллективный:  коллективным
хаба:  хабы
тема:  тему
сайт:  сайт
планировать:  планируем
технология:  технологий
сутки:  сутки
вернуться:  вернуться
хабрахабра:  хабрахабре
добавить:  добавить
текст:  тексты
поиск:  поиск
просмотр:  просмотров
система:  системой
яндекс:  яндекс
хабра:  хабр
публиковать:  публиковать
аналогичный:  аналогичной
блогер:  блоггеров
подкаст:  подкасты
публикация:  публикации
карма:  карма
возможность:  возможность
колонка:  колонках
страница:  странице
закладка:  закладки
тег:  теги
обновить:  обновить
идея:  идея
человек:  людей
анонс:  анонсов
высокий:  высоких
