повод:  поводу
похожий:  похожие
хороший:  лучшие
подкастобзоротчечественныйсписокстрельник:  подкастобзоротчечественныйсписокстрельников
комментарий:  комментарии
профиль:  профиль
история:  истории
сервис:  сервисы
дзен:  дзен
старый:  старую
язык:  язык языка
мина:  мин
меню:  меню
лев:  лев
очетественный:  очетественные
поддержка:  поддержка
прочтение:  прочтение
технический:  техническая
чулан:  чулан
отечественный:  отечественных
голос:  голосов
какой:  какие
настройка:  настройка
версия:  версию
предлагать:  предлагает
рейтинг:  рейтинг
количество:  количество
авг:  авг
обзор:  обзор
стрельников:  стрельникова
хаба:  хабы
василий:  василия
сутки:  сутки
вернуться:  вернуться
подобный:  подобные
добавить:  добавить
сделать:  сделайте
товарищ:  товарищ
поиск:  поиск
проект:  проект
просмотр:  просмотров
пользователь:  пользователь
яндекс:  яндекс
вопрос:  вопрос
расчёт:  расчет
брать:  брать
хабра:  хабр
публикация:  публикации
карма:  карма
закладка:  закладки
тег:  теги
обновить:  обновить
знать:  знает
