форма:  форме
комментарий:  комментарии
профиль:  профиль
эффективность:  эффективность
вполне:  вполне
дзен:  дзен
дело:  деле
концепция:  концепция
интернет:  интернет
сторона:  сторона
мститель:  мстителей
думать:  думаете
радость:  радость
меню:  меню
прочтение:  прочтение
направить:  направлено направлена
поддержка:  поддержка
всякий:  всякие
мл:  мл
находиться:  находится
побочный:  побочные
отличаться:  отличается
усилить:  усилят
версия:  версию
додумывать:  додумывать
рейтинг:  рейтинг
тысяча:  тысячи
десятка:  десятки
армия:  армии
авг:  авг
буш:  бушу буш
почувствовать:  почувствовать
хаба:  хабы
сеть:  сети
дмитрий:  дмитрий
мир:  мире
сутки:  сутки
нужный:  нужный
прийтись:  прийдется
вернуться:  вернуться
подобный:  подобные
бригада:  бригаде
получаться:  получается
привлекательность:  привлекательность
поиск:  поиск
проливать:  проливает
деятельность:  деятельностью
программка:  программку
разослать:  разослать
концлагерь:  концлагерях
реализовать:  реализована
отстраиваться:  отстраиваться
участник:  участников участником
добрый:  доброй
закладка:  закладки
обновить:  обновить
часть:  части
легко:  легко
превратить:  превратит
общность:  общность
неприятный:  неприятном
ассоциироваться:  ассоциируется
установить:  установить
повод:  поводу
хороший:  лучшие
участвовать:  участвуют
который:  которое которому
цель:  целей цели
приглашение:  приглашение
прогнозировать:  прогнозирует
история:  истории
старый:  старую старой
должный:  должны должна
этический:  этическая
мощь:  мощи
пихтый:  пихто
язык:  язык языка
немногое:  немногим
задумать:  задуманного
акция:  акциях акции
выстрел:  выстрела
например:  например
оружие:  оружие оружия
атака:  атаки
новость:  новость
значимость:  значимость
привычно:  привычно
количество:  количество
становиться:  становится
сайт:  сайт сайтов
поддержать:  поддержать
странно:  странно
посмотреть:  посмотреть
момент:  момент
правозащитный:  правозащитные
хакер:  хакеров
победитель:  победителей
отображать:  отображает
сервер:  сервер сервера
разместить:  разместить
переставать:  перестает
джордж:  джорджу
распространение:  распространение
вещь:  вещи
хабра:  хабр
совершение:  совершения
кровь:  крови
пользователь:  пользователей пользователю пользователь
необходимый:  необходимое
идея:  идея
пытка:  пытки
осознавать:  осознающие
офлайновый:  оффлайновой
натуральный:  натуральных
голова:  голову
странный:  странной
доступный:  доступной
атаковать:  атакуемого
отвечать:  отвечать
высказать:  высказать
ошибочный:  ошибочных
нажать:  нажав
отклик:  отклик
удовольствие:  удовольствием
предлагаться:  предлагается
пуск:  пуск
небольшой:  небольшую
пролетариат:  пролетариата
народный:  народных
широкий:  широкое
прийти:  пришло
просмотр:  просмотров
организация:  организации
яндекс:  яндекс
объединиться:  объединились
присоединиться:  присоединиться
говорить:  говоря
такой:  таких
маскироваться:  маскируясь
помочь:  помочь
публикация:  публикации
автоматически:  автоматически
собственноручно:  собственноручно
анимировать:  анимированный
тег:  теги
победа:  победе
человек:  людей
друг:  друзьям
участие:  участия
обычный:  обычного
похожий:  похожие
отношение:  отношение
сервис:  сервисы
справедливость:  справедливость
ход:  ходе
обеспечить:  обеспечить
причём:  причем
американский:  американских
реальный:  реальные
мина:  мин
вызывать:  вызывает
экологический:  экологические
конкурент:  конкурентов
рисовать:  рисует
чулан:  чулан
действие:  действия
заключаться:  заключается
запрос:  запросы
осознание:  осознании
простота:  простота
настройка:  настройка
технический:  техническая
сомнение:  сомнения
использование:  использование
столько:  столько
абсолютный:  абсолютная
завал:  завале завал
лежать:  лежит
отслеживать:  отслеживает
вторично:  вторично
давать:  дает
противный:  противный
падать:  падает
добавить:  добавить
разнести:  разнесут
факт:  факта
покрывать:  покрывающему
кнопка:  кнопку
убеждение:  убеждениям
бот:  боты
сигнал:  сигнал
сми:  сми
пк:  пк
поверхность:  поверхности
хватать:  хватает
возможность:  возможность
красный:  красных
карма:  карма
злоумышленник:  злоумышленники
сразу:  сразу
шпионский:  шпионское
виртуальный:  виртуальной
