похожий:  похожие
июл:  июл
хабрахабра:  хабрахабр
хороший:  лучшие
ответ:  ответа
задавать:  задаваемые
равно:  равно
комментарий:  комментарии комментариях
профиль:  профиль профиле
история:  истории
дзен:  дзен
сайт:  сайте сайта сайт
составление:  составления
старый:  старую
такой:  таким
карьера:  карьера
писать:  пишите
язык:  язык языка
мина:  мин
обращаться:  обращаюсь
прочтение:  прочтение
меню:  меню
идея:  идея
поддержка:  поддержка
сборник:  сборника
технический:  техническая
голос:  голосов
читатель:  читателям
настройка:  настройка
конкретный:  конкретному
группа:  группы
доступный:  доступны
рейтинг:  рейтинг
версия:  версию
количество:  количество
хаба:  хабы
один:  одним
чаво:  чаво
сутки:  сутки
вернуться:  вернуться
вопрос:  вопрос
добавить:  добавить
поиск:  поиск
просмотр:  просмотров
смысл:  смысл
яндекс:  яндекс
хабра:  хабр
использовать:  используя
коллективный:  коллективным
решить:  решило
следующий:  следующим
карма:  карма
публикация:  публикации
подходить:  подходит
остаться:  оставшихся
закладка:  закладки
тег:  теги
обновить:  обновить
привет:  привет
человек:  людей
посему:  посему
поскольку:  поскольку
идеально:  идеально
забыть:  забыл
отсутствовать:  отсутствует
отличаться:  отличается
ошибка:  ошибку
о:  обо
юрий:  юрий
баландин:  баландин
пользователь:  пользователь
трудный:  трудный
разобраться:  разобраться
недоделка:  недоделок
знать:  знает
страница:  страница
неработающий:  неработающих
найти:  найдена
устареть:  устарела
вовсе:  вовсе
главный:  главную
существовать:  существовала
удалить:  удалена
выбрать:  выбранного
провести:  проведут
неформальный:  неформальную
маслов:  маслов
должный:  должны
чулан:  чулан
насколько:  насколько
рамблер:  рамблер
журналист:  журналистами
местный:  местных
бояться:  бояться
ведомость:  ведомостях
партнёр:  партнеров
опубликовать:  опубликованные
рынок:  рынке
встреча:  встречу
агентство:  агентство
пиарить:  пиарят
россия:  россии
сокура:  сокур
закрытый:  закрыт
доступ:  доступ
трансляция:  трансляции
готовый:  готовой
первый:  первую
достаточно:  достаточно
думать:  думаю
наполнение:  наполнение
раздел:  разделы
тема:  темы
планировать:  планируем
технология:  технологиях технологий
текст:  текст
система:  системы
публиковать:  публиковать
аналогичный:  аналогичной
блогер:  блоггеров
подкаст:  подкаст
возможность:  возможностей возможность
колонка:  колонки
анонс:  анонс
высокий:  высоким
чекбокс:  чекбоксов
титов:  титов
логин:  логина логин
самопроизвольно:  самопроизвольно
уверенный:  уверен
смена:  смене
павел:  павел
несмотря:  несмотря
ощущение:  ощущение ощущения
разлогинивание:  разлогинивание
возможно:  возможно
самопроизвольный:  самопроизвольное
происходить:  происходит
включить:  включен
несколько:  нескольку
популярный:  популярного
интересно:  интересно
аудитория:  аудитории
ресурс:  ресурсов ресурсы
основное:  основном
телефония:  телефонии
пользоваться:  пользоваться
интересовать:  интересует
популярность:  популярность популярности
среди:  среди
становиться:  становится
неожиданный:  неожиданная
российский:  российский
вроде:  вроде
который:  которую
латиноамериканец:  латиноамериканцы
получаться:  получается
индиец:  индийцев
региональный:  региональная региональной
протокол:  протоколом
создаваться:  создаются
русскоязычный:  русскоязычной
страна:  странах
получиться:  получилось
социальный:  социальная социальную социальных
сделать:  сделать
трудно:  трудно
коментарий:  коментарий
принцип:  принципу принципа
пост:  посты постов
ссылка:  ссылку
удаление:  удаление
редактирование:  редактирования
сказать:  сказанное
неуютный:  неуютно
просмотреть:  просмотренной
пометка:  пометки
круто:  круто
ранее:  ранее
предложениекомментарий:  предложениекомментарии
новый:  новый
говорить:  говорю
общий:  общего
сообщество:  сообществ
имхо:  имхо
однородный:  однородного
величко:  величко
александр:  александра
бегун:  бегуном бегун
сеть:  сети
комби:  комби
вариант:  вариантов
жизнеспособный:  жизнеспособным
область:  области
подход:  подходы
нишевый:  нишевого
рамка:  рамках
смотреть:  см
формирование:  формирование
огромный:  огромными
сомнительно:  сомнительно
эффект:  эффект
возникать:  возникает
предметный:  предметной
формировать:  формировать
великий:  великая
единственно:  единственно
показать:  покажет
цифра:  цифры
отдельный:  отдельное
интерес:  интересов интересы
создавать:  создавая
создание:  создания
дешёвый:  дешевого
третий:  третье
признак:  признаки
некий:  некий
случай:  случае
контролироваться:  контролируется
существующий:  существующих
подумать:  подумать
введение:  введение
контент:  контента контент
любитель:  любителей
вызывать:  вызывает
логика:  логика
скажем:  скажем
деньга:  деньги
являться:  являются
отношение:  отношения
вещь:  вещью
бренд:  брендов
сразу:  сразу
откуда:  откуда
копейка:  копейки
хабрахабрпоиск:  хабрахабрпоиск
работат:  работат
работать:  работать работает
блог:  блог
многий:  многим
список:  списка списке список списку
предлагать:  предлагает
статистика:  статистики
хабрахабррекомендациирейтингпредпочтение:  хабрахабррекомендациирейтингпредпочтения
какой:  какие
состоять:  состоят
узнать:  узнать
спрашивать:  спрашивал
строить:  строить
три:  трем
категория:  категориям
транслировать:  транслировать
далее:  далее
расширить:  расширен
пользовательский:  пользовательском
сми:  сми
предпочтение:  предпочтение
вероятно:  вероятно
рекомендация:  рекомендации
читать:  читает
сбор:  сбора
второй:  вторую
образовательный:  образовательная
пример:  примера
чистый:  чистых
давать:  давать
направление:  направлении
миграция:  миграция миграции
мимикрия:  мимикрии
хуан:  хуан
домен:  доменов домены
гугл:  гугла
рамон:  рамон
занятный:  занятный
использоваться:  используется
тэг:  тэги
метка:  меток
таг:  тагами
исправить:  исправить
обозначение:  обозначения
википедия:  википедию
русский:  русском
владислав:  владислава владислав
лингвый:  лингво
семён:  семенов
хабрахаброшибкитег:  хабрахаброшибкитеги
слово:  словах
константин:  константин
рощупкина:  рощупкин
кнопка:  кнопки
расценка:  расценки
хабрахабрконтекстный:  хабрахабрконтекстная
доделать:  доделаете
контекстный:  контекстной
реклама:  реклама
выводиться:  выводится
новость:  новостей
хабрахабркомментарий:  хабрахабркомментарии
удобный:  удобней
сильно:  сильно
заголовок:  заголовком
жизнь:  жизнью
блогзаголовок:  блогзаголовок
отражаться:  отражаются
голицын:  голицына
странно:  странно
настя:  настя
камент:  камента
жить:  живет
отдаваться:  отдаваться
иметься:  имеется
штука:  штука
вместе:  вместе
скобка:  скобках
запрос:  запросам
обновляться:  обновляется
коммент:  комменты
тред:  треде
совершенно:  совершенно
написать:  написать
показывать:  показывать
иванов:  иванов
палец:  пальцем
полезный:  полезна
умудряться:  умудряется
свой:  свой
роман:  роман
бессмысленный:  бессмысленных
каждый:  каждой
фича:  фича
отображаться:  отображались
здорово:  здорово
выиграть:  выиграет
принимать:  принимать
узнавать:  узнавать
сторннний:  сторннних
увеличить:  увеличить
пингбек:  пингбеков пингбеки
принятие:  принятие
стать:  стали
мнение:  мнение
больший:  большим больший
хабрахабртрекбекипингбек:  хабрахабртрекбекипингбеки
трекбек:  трекбеки трекбеков
ссылаться:  ссылаться
трафик:  трафика
подробность:  подробности
позволить:  позволит
остальной:  остальном
эффективность:  эффективность
оживить:  оживить
дорого:  дорого
улендеев:  улендеева улендеев
цент:  цента
весь:  всей
правый:  правы
реальный:  реальный
итак:  итак
ответить:  ответит
посетитель:  посетителя
работа:  работы
сидеть:  сидят
кликать:  кликаю
верно:  верно
получать:  получает
мощь:  мощи
искать:  искал
интервью:  интервью
спросить:  спросить
никакой:  никаких
холдинг:  холдинга
утверждение:  утверждение
коммерциявладислав:  коммерциявладислав
маркет:  маркете маркетом
уметь:  умею умеем
буквально:  буквально
камень:  камней
поисковик:  поисковиков поисковиках
точность:  точностью
простой:  просты
активно:  активно
рекламироваться:  рекламируемся рекламироваться
электронный:  электронный
исполнительный:  исполнительный
участвовать:  участвуют
источник:  источников
результат:  результат
пробовать:  пробовали
директор:  директор
считать:  считать
эффективный:  эффективное эффективной
улендеевэффективностьтрафить:  улендеевэффективностьтрафи
практически:  практически
эффективно:  эффективно
покупатель:  покупателей
робот:  робот
причина:  причины
войти:  вошел
плачевный:  плачевный
подводный:  подводных
серьёзный:  серьезная
интернет:  интернет
существенно:  существенно
счёт:  счета
позиция:  позиции
суровый:  суровый
судить:  судя
повсеместный:  повсеместного
данные:  данных
мысль:  мысли
онлайн:  онлайн
обслуживание:  обслуживания
сезонность:  сезонность
торговляэлектронный:  торговляэлектронная
явно:  явно
ожидать:  ожидать
заявить:  заявленных
никто:  никто
качество:  качестве
рунет:  рунете
плохой:  хуже
прошлый:  прошлом
уменьшиться:  уменьшилась
коллега:  коллега коллеги
горшков:  горшков
активность:  активность
стагнация:  стагнации
дело:  дела
пожаловаться:  пожаловалось
удивительно:  удивительно
спад:  спада спад
отвратительный:  отвратительного
коммерцияинтернуть:  коммерцияинтернет
начинать:  начинать
покупать:  покупать
последний:  последняя
обстоять:  обстоят
конец:  концу
продажа:  продажи
расхотеться:  расхотелось
магазинрун:  магазинрун
сдавать:  сдавать
период:  период
другой:  другого
открыть:  открыл
задаться:  задался
код:  код
отзыв:  отзывам
аудиредактор:  аудиредактор
неделя:  неделе
записывать:  записывать
совет:  совет
поэтому:  поэтому
исходный:  исходным
признательный:  признателен
например:  например
операционный:  операционными
дать:  дайте
начинаться:  начинается
открытый:  открытого
программа:  программ
публичный:  публичный
софт:  софт
распространить:  распространенная
подкастинг:  подкастинги
блоггинга:  блоггинг
свободный:  свободном
запись:  записи
внешний:  внешние
господин:  господа
будущее:  будущем
статья:  статьи
предполагаться:  предполагалось
учить:  учить
мешать:  мешают
бережно:  бережно
изначально:  изначально
отслеживаться:  отслеживаются
интересный:  интересные
лично:  лично
папка:  папки
заговорить:  заговорил
плюс:  плюс плюса
повод:  поводу
избранный:  избранных избранные избранное
собраться:  собрались
новотёк:  новотека
ашманов:  ашманову
прочитать:  прочитав
делать:  делать
выглядеть:  выглядеть
представление:  представления
указание:  указанием
таковой:  таковой
вывод:  выводом
задонатить:  задонатить
бесконечный:  бесконечной
сервис:  сервисы
наверняка:  наверняка
хотеть:  хотел
копировать:  копировать
мой:  моему
цитировать:  цитировать
хранить:  хранить
организовать:  организовать
ибо:  ибо
хотеться:  хочется
мочь:  могу
проект:  проект
банально:  банально
обсуждение:  обсуждение
попадать:  попадает
инфо:  инфо
персональный:  персональный
надеяться:  надеется
брендировать:  брендировать
эпизод:  эпизод
окно:  окне
дмитрий:  дмитрий
серия:  серии
наш:  наших
пропустить:  пропустил пропущенный
поллучиться:  поллучился
понравиться:  понравилось
совместно:  совместно
коварный:  коварных
карта:  карта карту
клан:  кланов
ждать:  ждать
преступление:  преступлений
вылезать:  вылезают
лежать:  лежит
место:  место
пытаться:  пытаться
мера:  мере
успеть:  успел
мафиозный:  мафиозных
нужный:  нужной
обидеть:  обидели
придумать:  придумал
сериал:  сериалов
крайний:  крайней
применять:  применяемых
серчинга:  серчинг
ошибиться:  ошибусь
заметный:  заметным
убить:  убей
носитель:  носитель
специалист:  специалисты
ульянов:  ульянов
поверхность:  поверхности
пометить:  помечена
почта:  почте почту
приходить:  приходят
хабрахабрхабратредпочта:  хабрахабрхабратредпочта
хабратредстартер:  хабратредстартеру
корневой:  корневой
хабратред:  хабратред
рекомендовать:  рекомендуем рекомендуете
загрузить:  загрузить
решение:  решения
указать:  указать указан
подкастинглюбимыерекомендацииобсуждениепредпочта:  подкастинглюбимыерекомендацииобсуждениепредпочт
слушать:  слушал
смочь:  сможем
самый:  самое
предпочитать:  предпочитаете
скриншот:  скриншот
нравиться:  нравятся
шота:  шот
скрин:  скрин
форма:  форме
эмоциирезюмир:  эмоциирезюмир
функция:  функции
общение:  общения
желать:  желающий
высказывание:  высказывание
краткий:  краткий
адекватный:  адекватное
сюда:  сюда
понять:  понял
резюмирование:  резюмирование
реплика:  реплики
деталь:  деталях
предложениефункциональностьобщениеответный:  предложениефункциональностьобщениеответные
посмотреть:  посмотрев
воспользоваться:  воспользоваться
редкий:  редких
молчание:  молчание
игнора:  игнор
означать:  означает
понятно:  понятно
зайти:  зашел
деликатный:  деликатное
почитать:  почитать
выпад:  выпады
умный:  умное
рад:  рад
резюме:  резюме
ознакомиться:  ознакомиться
заходить:  заходят
принадлежать:  принадлежит
новинка:  новинки
захотеть:  захотел
потенциал:  потенциал
понятие:  понятий
обсудить:  обсудить
инф:  инфу
собираться:  собирался
салага:  салага
взгляд:  взгляд
узкий:  узкая
очевидный:  очевидным
примерно:  примерно
правильно:  правильно
смеяться:  смейтесь
поместить:  поместить
брендинг:  брендинг
абстрактный:  абстрактных
сливать:  сливаю
условие:  условиях
заинтересовать:  заинтересовать
пара:  пару
отлично:  отлично
иметь:  имеет
строгий:  строгих
разрез:  разрезе
линк:  линки
осознать:  осознал
брайан:  брайан
содержимое:  содержимое
шустрый:  шустер
ввести:  ввести
сообщение:  сообщение
эротический:  эротической эротическими
правило:  правила
компания:  компании
сотрудник:  сотрудники
род:  рода
успех:  успех
намерить:  намерена
отслеживать:  отслеживает
фото:  фото
сетевой:  сетевой
потребоваться:  потребуется
повторить:  повторить
оператор:  оператор
вход:  вход
разрешить:  разрешен
ваховский:  ваховский
предмет:  предмет
подростковый:  подросткового
миллион:  миллиона
запретить:  запрещен
взрослый:  взрослых
кредитный:  кредитной
видеоигра:  видеоигры
гаразды:  гаразд
обмен:  обмен
фантазия:  фантазий
специальный:  специальная
номер:  номера
регистрация:  регистрации
привлечь:  привлекла
клинический:  клинический
даниил:  даниил
несовершеннолетний:  несовершеннолетних
лицо:  лицам
антон:  антон
забанный:  забанных
молодёжный:  молодежных молодежной
отобрать:  отобранных
шоу:  шоу
тренд:  тренд
доля:  доля
маркетинговый:  маркетингового
помнить:  помните
море:  моря
скоро:  скоро
аккаунт:  аккаунты
заключать:  заключает
коммуникация:  коммуникация
карибский:  карибского
френд:  френдами
тинэйджер:  тинэйджерами
бизнес:  бизнеса
потребительский:  потребительского
сша:  сша
аудитоия:  аудитоий
наравне:  наравне
июль:  июля
пять:  пяти
необходимый:  необходимое
шутка:  шутка
скрупулёзно:  скрупулезно
сфера:  сфере
планета:  планете
студия:  студии
частый:  частые
знание:  знания
промоутировать:  промоутируя
владелец:  владельцев
затрагивать:  затрагивают затрагивающих
выпускать:  выпускает
фокусировка:  фокусировки
продукт:  продукте
старший:  старше
пират:  пиратов
посредством:  посредством
услуга:  услуги
привлекать:  привлекает
телевизионный:  телевизионные
издание:  изданиях
занимать:  занимают
обзор:  обзор
пресса:  прессы
приготовиться:  приготовьтесь
важный:  важнее важны
приводить:  приводит
газета:  газет газетой
предложить:  предложить
вместо:  вместо
посещаемость:  посещаемости
поведение:  поведения
консалтинговый:  консалтинговые
прямой:  прямой
успешно:  успешно
к:  ко
сомнительный:  сомнительной
личный:  личные
наугад:  наугад
продюсер:  продюсеры
поздний:  поздние
крейн:  крейном
музыкальный:  музыкальные
занятой:  занятые
устраивать:  устраивают
молодой:  молодыми
самовыражение:  самовыражения
кастинг:  кастинга
исследование:  исследование
главное:  главное
дежавю:  дежавю
рука:  руках
мелкий:  мелкого
рекламный:  рекламная рекламных рекламную
двадцать:  двадцати
отставать:  отставать
сиквел:  сиквела
клуб:  клубов
иначе:  иначе
вообще:  вообще
художник:  художники
ресторан:  ресторанов
бесплатный:  бесплатный
собственный:  собственное
таргетированность:  таргетированность
кампания:  кампания
дизайнер:  дизайнеры
жаждать:  жаждущие
занятие:  занятия
продвигать:  продвигать
одновременно:  одновременно
социализироваться:  социализирующиеся
основный:  основных
автор:  автором авторов
переводить:  переводить
монстр:  монстров
тридцать:  тридцати
девяностый:  девяностые
взрослеть:  взрослеет
запоздалый:  запоздалые
неизбежный:  неизбежном
печатать:  печатали
подросток:  подростки
оказываться:  оказывается
шестой:  шестое
следствие:  следствие
рэнс:  рэнса
смежный:  смежным
упаковка:  упаковке
изнутри:  изнутри
купить:  купит
креатив:  креативе
подтверждать:  подтверждает
подробно:  подробно
наблюдение:  наблюдение
уверить:  уверены
культура:  культуры
скорее:  скорее
совпасть:  совпали
понятный:  понятные
невозможно:  невозможно
функционал:  функционала
создать:  созданный
максимум:  максимум
мегабеглый:  мегабеглый
данный:  данный
кликнуть:  кликну
рассказ:  рассказ
рекламодатель:  рекламодатели
мозг:  мозг
воздействие:  воздействии
таргетирование:  таргетирование
тв:  тв
интеграция:  интеграции
офлайн:  оффлайн
момент:  момент
прятать:  прятать
маркетинг:  маркетинг
умничанье:  умничанья
разрабатывать:  разрабатываемые
всяческий:  всяческий
креативный:  креативного
авторитетный:  авторитетной
информация:  информации
рекламист:  рекламисты
основной:  основные
включая:  включая
положение:  положение
копирайт:  копирайте
правильный:  правильные
баннер:  баннеру
пассивный:  пассивное
онлайновый:  онлайновые
проглотить:  проглотить
желание:  желание
отсутствие:  отсутствие
комментировать:  комментировать
зритель:  зритель
сёрфер:  серфер
необходимость:  необходимость
посыл:  посыл
таргетировать:  таргетировать
связать:  связано
мощный:  мощного
изучать:  изучают
изменить:  изменили
призвать:  призвано
активный:  активный
прочесть:  прочесть
старикан:  стариканов
победитель:  победителей
вирусный:  вирусных
ролик:  ролику
блогостратегия:  блогостратегии
переехать:  переехать
напиток:  напиток
талант:  талантом
число:  числом
стратегически:  стратегически
безошибочный:  безошибочной
находиться:  находится
непонравиться:  непонравившихся
кингдом:  кингдом
авг:  авг
майами:  майами
путешествовать:  путешествуют
умно:  умно
подобный:  подобных
запускать:  запускает
направлять:  направляющие
некролог:  некрологов
париж:  париж
тейлор:  тейлор
повторять:  повторяю
печатный:  печатных
неограниченный:  неограниченном
участник:  участников участником
описывать:  описывать
будущий:  будущих
клип:  клипы
помогать:  помогает
социально:  социально
юноша:  юношей
баннерный:  баннерные
иллюстрация:  иллюстрация
социум:  социум
голосование:  голосования голосование
идти:  шла
знакомить:  знакомящих
видеосюжет:  видеосюжет
приближаться:  приближающихся
маркетолог:  маркетологи
имейл:  имейл
интерактивный:  интерактивное
менять:  меняют
кингдон:  кингдон
завести:  завести
аккуатный:  аккуатно
предлагаться:  предлагается
чужой:  чужих
блогосфера:  блогосфера блогосферой
бесполезно:  бесполезно
короткий:  короткий
комьюнити:  комьюнити
вид:  виду
выбирать:  выбирать
собрать:  собрать
беглый:  беглый
американский:  американских
видео:  видео
мечта:  мечта мечты
благополучие:  благополучие
девушка:  девушек
размещение:  размещение
разсылай:  разсылая
продвижение:  продвижение
перспективный:  перспективнейшим
любовь:  любовь
точечный:  точечной
узко:  узко
пенсия:  пенсии
пенсионер:  пенсионеров пенсионеры
трендсеттер:  трендсеттеров
брендирование:  брендировании
взамен:  взамен
присылать:  присылаемый
любой:  любой
голосовать:  голосовать
развитие:  развития
осуществить:  осуществить
основатель:  основатель
юзер:  юзера
медиа:  медиа
известный:  известные
задача:  задача
исключать:  исключают
стадия:  стадии
сфокусировать:  сфокусированное
пиар:  пиар
восхищаться:  восхищается
стремиться:  стремиться
спонсор:  спонсор
энергетический:  энергетическим
сентябрь:  сентября
база:  базе
полный:  полная
совпадение:  совпадении
жительство:  жительства
внутри:  внутри
площадка:  площадки
полететь:  полетят
джефф:  джефф
благополучный:  благополучных
практический:  практическом
финансы:  финансы
красота:  красоты красота
воплощение:  воплощении
необходимо:  необходимо
замечательный:  замечательное
стандартный:  стандартные
нести:  несут
смысловой:  смысловой
оценка:  оценки оценкой
галочка:  галочка
уместный:  уместней
юзабельный:  юзабельной
определяться:  определялось
общениеюзабилитихабрахабра:  общениеюзабилитихабрахабр
ы:  ы
удобно:  удобно
положительный:  положительная
проблема:  проблем
случайно:  случайно
вообщий:  вообщем
минус:  минус
поставить:  поставил
воспринимать:  воспринимаю
изображение:  изображениям
нагрузка:  нагрузки
крестик:  крестик
просить:  просить
размещаться:  размещалась
суммарный:  суммарная
отрицательный:  отрицательная
точнее:  точнее
поменять:  поменять
знак:  знак знаком
анатолий:  анатолий
пострадать:  пострадает
гораздо:  гораздо
картинка:  картинок
стандарт:  стандартам
прощение:  прощения
панелька:  панелька
браузер:  браузера
облако:  облако
добавление:  добавления
максимальный:  максимальной
друг:  друзей
пройти:  прошло
нежели:  нежели
нажать:  нажав
вероятность:  вероятность
присутсвовать:  присутсвуют
добавляться:  добавляться
функциональность:  функциональность
нажатие:  нажатия
юзабилить:  юзабилити
минимум:  минимум
комфортный:  комфортные
собственно:  собственно
ужастъ:  ужастъ
тяжёлый:  тяжелым
размещать:  размещаю
путаться:  путаться
автоматически:  автоматически
ввид:  ввиде
придерживаться:  придерживаясь
выводить:  выводить
набрать:  набрать
причём:  причем
действие:  действий
геометрически:  геометрически
пускай:  пускай
добавиться:  добавился
использование:  использовании использования
поле:  поле
юзабилититэгиидеихабрахабра:  юзабилититэгиидеихабрахабр
обеспечить:  обеспечить
статьимнениепубликация:  статьимнениепубликации
попадаться:  попадается
находка:  находки
основать:  основанных
перекодировка:  перекодировки
таблица:  таблицу таблицы
вполне:  вполне
развиватель:  развиватель
множество:  множество
комментариикодировкипочта:  комментариикодировкипочта
алексей:  алексей
смешной:  смешным
капрановый:  капранов
необязательно:  необязательно
эротика:  эротике
порнография:  порнографией
буква:  буква
явка:  явки
рассказать:  рассказать
слышать:  слышал
зарабатывать:  зарабатывать
пароль:  пароли пароль
дрогановый:  дроганов
траффик:  траффика
спец:  спецам
платить:  платил
сергей:  сергей
профит:  профит
мб:  мб
мастерхост:  мастерхост
вебмастер:  вебмастерам
опыт:  опыт
странный:  странной
структура:  структура
пук:  пуках
шар:  шар
сравнить:  сравнить
трёхмерный:  трехмерных трехмерная
потратить:  потратив
пихтый:  пихто
куб:  куб
оружие:  оружие оружия
речь:  речь
честно:  честно
кой:  коем
навигация:  навигация
плоскость:  плоскость
нарисовать:  нарисовать
разный:  разного
вебстраничка:  вебстраничек
старт:  старт
абстрагироваться:  абстрагируемся
интернетаформа:  интернетаформа
попытка:  попыток попытки
негатив:  негатива
начать:  начать
некоторый:  некоторые
мертворождённый:  мертворожденная
способ:  способ
знакомый:  знакомым знакомых
свежевыпечь:  свежевыпеченной
интересоваться:  интересовался
альтернативный:  альтернативным
измерить:  измерить
голова:  голову
представлять:  представляют
странность:  странности
перемещение:  перемещение
образ:  образом
красивый:  красивый
интернетаальтернативный:  интернетаальтернативная
постоянно:  постоянно
мыло:  мыло
рыбак:  рыбак
выслать:  выслать
дебаг:  дебаг
восстановить:  восстановить
вываливать:  вываливает
объект:  объекта
наличие:  наличия
восстановление:  восстановление
описать:  описать
перл:  перле
хабраперл:  хабраперл
вкратце:  вкратце
фетишист:  фетишистов
уважаемый:  уважаемый
лев:  лев
жать:  жмем
недочетик:  недочетик
адресный:  адресной
переадресовать:  переадресует
строка:  строк
сбк:  сбк
коэффициент:  коэффициент
расчитываться:  расчитывается
сортировать:  сортировать
рейтингкармасбк:  рейтингкармасбк
учитываться:  учитываться учитывается
разметить:  размеченная
микроформат:  микроформаты микроформатах
россомахина:  россомахин
максим:  максим
сообразно:  сообразно
полочка:  полочкам
упорядочивание:  упорядочиванию
исходить:  исходя
кстати:  кстати
любопытство:  любопытства
разложить:  разложена
лазить:  лазить
ткнуть:  ткнуть
поудалять:  поудаляв
технически:  технически
стих:  стихов
уверенно:  уверенно
отличие:  отличие
профессионал:  профессионалов
появиться:  появилось
имя:  имена
пофантазировать:  пофантазировать
гадать:  гадать
понажимать:  понажимать
вебсёрфер:  вебсерфер
час:  час
ящик:  ящиков
попробовать:  попробуйте попробовать
каталог:  каталогов
спам:  спам
склонность:  склонность
впрямую:  впрямую
месяц:  месяц
виноватый:  виновата
прикольно:  прикольно
любимый:  любимый
скучать:  скучающими
книга:  книге
скрываться:  скрывается
укладываться:  укладывается
алфавитный:  алфавитный
предсказуемый:  предсказуем
задать:  задать
отметиться:  отметившись
побродить:  побродить
порядок:  порядке
привлекательный:  привлекательные
неинтересный:  неинтересно
раскладывание:  раскладыванию
реализовать:  реализовать
человеческий:  человеческая
закинуть:  закинула
судьба:  судьба
наверное:  наверное
обязательность:  обязательность
незнать:  незнаю
концепция:  концепцию
сторона:  стороны
мститель:  мстителей
радость:  радость
направить:  направлено направлена
всякий:  всякие
мл:  мл
побочный:  побочный
усилить:  усилят
додумывать:  додумывать
тысяча:  тысячи
десятка:  десятки
армия:  армии
буш:  бушу буш
почувствовать:  почувствовать
мир:  мире
прийтись:  прийдется
бригада:  бригаде
привлекательность:  привлекательность
проливать:  проливает
деятельность:  деятельности
программка:  программку
разослать:  разослать
концлагерь:  концлагерях
отстраиваться:  отстраиваться
добрый:  доброй
часть:  частей
легко:  легко
превратить:  превратит
общность:  общность
неприятный:  неприятном
ассоциироваться:  ассоциируется
установить:  установить
цель:  целей цели
приглашение:  приглашение
прогнозировать:  прогнозирует
этический:  этическая
немногое:  немногим
задумать:  задуманного
акция:  акциях акции
выстрел:  выстрела
атака:  атаки
значимость:  значимость
привычно:  привычно
поддержать:  поддержать
правозащитный:  правозащитные
хакер:  хакеров
отображать:  отображает
сервер:  сервер сервера
разместить:  размещенных
переставать:  перестает
джордж:  джорджу
распространение:  распространение
совершение:  совершения
кровь:  крови
пытка:  пытки
осознавать:  осознающие
офлайновый:  оффлайновой
натуральный:  натуральных
атаковать:  атакуемого
отвечать:  отвечают
высказать:  высказать
ошибочный:  ошибочных
отклик:  отклик
удовольствие:  удовольствием
пуск:  пуск
небольшой:  небольшую
пролетариат:  пролетариата
народный:  народная
широкий:  широкое
прийти:  пришел
организация:  организации
объединиться:  объединились
присоединиться:  присоединиться
маскироваться:  маскируясь
помочь:  помочь
собственноручно:  собственноручно
анимировать:  анимированный
победа:  победе
участие:  участие
обычный:  обычным
справедливость:  справедливость
ход:  ходе
экологический:  экологические
конкурент:  конкурентов
рисовать:  рисует
заключаться:  заключается
осознание:  осознании
простота:  простота
сомнение:  сомнения
столько:  столько
абсолютный:  абсолютная
завал:  завале завал
вторично:  вторично
противный:  противный
падать:  падает
разнести:  разнесут
факт:  факт
покрывать:  покрывающему
убеждение:  убеждению
бот:  боты
сигнал:  сигнал
пк:  пк
хватать:  хватает
красный:  красных
злоумышленник:  злоумышленники
шпионский:  шпионское
виртуальный:  виртуальной
представитель:  представители
отписаться:  отписаться
очередь:  очередь
безопасность:  безопасности
дверь:  двери
поток:  потока
крайне:  крайне
большинство:  большинству
непосвящённый:  непосвященных
подписаться:  подписаться
совпадать:  совпадает
хардинга:  хардинг хардинга
ограниченный:  ограниченную
чтение:  чтения
решать:  решает
уступать:  уступает
дерек:  дерек
указывать:  указывает
целевой:  целевую целевой
подписчик:  подписчик
инбокс:  инбокс
массовый:  массовом массовые
пункт:  пунктов
конкуренция:  конкуренция
закрывать:  закрывает
максимально:  максимально
ключевой:  ключевых
грозить:  грозит
природа:  природе
сложно:  сложно
ваш:  вашей
сегмент:  сегмент
сегодняшний:  сегодняшний
подписываться:  подписываться
старгетировать:  старгетированных
мейл:  мейл
камышева:  камышев
здравствуйте:  здравствуйте
приветствовать:  приветствую
уведомление:  уведомлений
арсений:  арсений
оставить:  оставив
официальный:  официальный
применение:  применения
модульность:  модульность
разметка:  разметки
внедряемость:  внедряемость
децентрализованный:  децентрализованной
суть:  сути
освоить:  освоенных
настоящий:  настоящая
внедрение:  внедрение
формат:  формату
набор:  набор
машина:  машин
поощрение:  поощрение
разработка:  разработку
специфичный:  специфичных
иной:  иного
переосмыслить:  переосмысленное
широко:  широко
календарь:  календаря
вводный:  вводное
вебстраница:  вебстраницы
перечень:  перечень
описание:  описания
трудность:  трудностей
составной:  составных
подсила:  подсилу
сагалаев:  сагалаев
иван:  иван
лениво:  лениво
перевод:  переводы перевод
подразумевать:  подразумевает
качественный:  качественный
засунуть:  засунуть
ревить:  ревью
материал:  материал
вобщий:  вобщем
регулярный:  регулярные
проанализировать:  проанализированные
перевести:  переведенные
некуда:  некуда
проверить:  проверить
глаз:  глаза
оказаться:  оказалось
видеть:  вижу
характеризовать:  характеризовать
подручный:  подручными
порно:  порно
броситься:  бросилось
получить:  получить
волгоград:  волгоград
нижний:  нижний
рост:  рост роста
население:  населения
попасть:  попасть
уфа:  уфа
попугай:  попугаи
выкладка:  выкладке
украина:  украины
несложный:  несложные
новгород:  новгород
средство:  средств средство
чисто:  чисто
непривычно:  непривычно
незамысловатый:  незамысловатым
выборка:  выборку
начинающий:  начинающие
картина:  картину
казань:  казань
гипотеза:  гипотеза
связь:  связей
сортировка:  сортировку
индикатор:  индикатор
город:  городах город города
статистический:  статистическое
горячий:  горячих
краснодар:  краснодар
владивосток:  владивосток
иркутск:  иркутск
арифметический:  арифметические
красноярск:  красноярск
семь:  семи
возникнуть:  возникла
увидеть:  увидел
ставрополь:  ставрополь
столица:  столиц
зона:  зон
беларусь:  беларуси
точка:  точек
последующий:  последующие
подвести:  подвел
реакция:  реакции
дублироваться:  дублируются
одинаковый:  одинаковым
запоститься:  запостилось
дизаблить:  дизаблить
либо:  либо
тачпад:  тачпад
борьба:  борьба
оп:  оп
боль:  боли
сычёв:  сычева
семинар:  семинар семинарах семинара
провайдер:  провайдеров провайдеры провайдера
революция:  революцию
выполняться:  выполняется
платёжный:  платежную платежного платежных
созреть:  созрела
тематический:  тематических
цена:  ценой
напомнить:  напомнило
генерировать:  генерируемый
скачать:  скачало
утяжеляться:  утяжеляется
недра:  недрах
соответсвенный:  соответсвенно
приблизительно:  приблизительно
мегабайтный:  мегабайтная мегабайтный
охота:  охота
держать:  держать
расцвет:  расцвет
мегабайт:  мегабайты
зарастать:  зарастает
файл:  файлов файлу
сухой:  сухой
произвести:  произвела
они:  ним
нереализуемый:  нереализуема
рассматриваться:  рассматривалась
уста:  уст
рассмотреть:  рассмотреть
маленький:  маленьким
тот:  той
вовремя:  вовремя
общеизвестный:  общеизвестны
недостаток:  недостатки
услышать:  услышать
валериевич:  валерьевича
ошибаться:  ошибаться
сравнение:  сравнению
значимый:  значимой
представить:  представить
несоизмеримый:  несоизмеримо
наступить:  наступил
выгодно:  выгодно
оценить:  оценить
идеальный:  идеальный
получение:  получения
утопичный:  утопична
схема:  схему
подключить:  подключены
платёж:  платежи
выплачивать:  выплачивая
рядовой:  рядового
искусственно:  искусственно
распространённость:  распространенность
инструмент:  инструмент
оплата:  оплатой оплаты
ввод:  вводом
ценить:  ценю
производить:  производят
пора:  поры
замысел:  замыслу
внутренний:  внутренняя
познакомиться:  познакомились
цифровой:  цифрового
взаимотребленный:  взаимотребленные
отдавать:  отдаваемых
выложить:  выложил
зачётный:  зачетному
файлик:  файлик
решаться:  решается
точный:  точного
денежка:  денежка
сложность:  сложность
остаток:  остаток
оплачивать:  оплачивать
программный:  программный
универсальный:  универсального универсальное
тропа:  тропа
малый:  малая
отчёт:  отчет
относительный:  относительная
повысить:  повысить
поисковый:  поисковое поисковый поисковых
проводиться:  проводится
тусовочный:  тусовочными
выходить:  выходят
буклет:  буклет
темп:  темпами
успешный:  успешной
расти:  растет растут
никита:  никите
преподаватель:  преподаватели
резюмировать:  резюмирует
тонкость:  тонкости
постоянный:  постоянной
мероприятие:  мероприятиями мероприятие
пятидневный:  пятидневный
проведение:  проведение
рассчитать:  рассчитать
цнтить:  цнти
рудняев:  рудняев
леонид:  леонид
чётко:  четко
конференция:  конференции
продвижениепартнерски:  продвижениепартнерски
объём:  объемы
петербург:  петербурге
незаметно:  незаметно
всероссийский:  всероссийской
ведущий:  ведущие
прогресс:  прогресс
филипп:  филипп
кулина:  кулин
киб:  киб
удержание:  удержания
чистовый:  чистов
грамотно:  грамотно
тематика:  тематики
профессиональный:  профессиональные
строчка:  строчки
инвестиция:  инвестиций
партнёрский:  партнерский
впервые:  впервые
план:  планах
быстро:  быстро
генеральный:  генеральный
затрата:  затраты
отбивать:  отбивающий
кушнер:  кушнеров
риф:  риф
лидерский:  лидерские
демидов:  демидову
румянцев:  румянцев
тайландобломрепортаж:  тайландобломрепортаж
обломать:  обломать
наткнуться:  наткнусь
уезжать:  уезжаю
корреспондент:  корреспондент
таиланд:  тайланда тайланд
отдых:  отдых
привезти:  привезти
критерий:  критерий
обещать:  обещают
экскюзивный:  экскюзивно
коллажик:  коллажик
фотографировать:  фотографировать
бангкок:  бангкоке
присутствие:  присутствия
патайя:  патайе
комментарииулучшение:  комментарииулучшения
комменарий:  комменарий
тип:  типа
провоцировать:  провоцирует
дискуссия:  дискуссии
крючков:  крючков
вадим:  вадим
высота:  высоте
большой:  большой
соответствовать:  соответствующий
письмо:  письма
тело:  теле
содержать:  содержал
обрабатываться:  обрабатывается
чистить:  чистить
присутствовать:  присутствует
разумеется:  разумеется
телефон:  телефонов
штоль:  штоли
исполниться:  исполнилось
ограничивать:  ограничивать
вверху:  вверху
евросеть:  евросеть
дубовик:  дубовиков
баг:  баг
примерный:  примерная
народ:  народу
хотяб:  хотябы
григорий:  григорий
дебют:  дебют
денискин:  денискин
бакунов:  бакунов
подкастобзоротчечественныйсписокстрельник:  подкастобзоротчечественныйсписокстрельников
очетественный:  очетественные
отечественный:  отечественных
стрельников:  стрельникова
василий:  василия
товарищ:  товарища
расчёт:  расчет
брать:  брать
обнаружить:  обнаружил
плохо:  плохо
сниться:  снятся
забыться:  забылся
сон:  сны сне сон
сонприснилосьинтернетфриспич:  сонприснилосьинтернетфриспич
утро:  утро
вспомнить:  вспомнить
присниться:  приснилось
бродить:  бродите
принципиально:  принципиально
куча:  кучи
беда:  беда
зарегистрироваться:  зарегистрировался
росновский:  росновский
неустранимый:  неустранимая
подкастер:  подкастер
элемент:  элементов
слева:  слева
дом:  дома
логотип:  логотипом
таки:  таки
ладный:  ладно
облазить:  облазил
макинтош:  макинтош
управление:  управления
программирование:  программировании
нога:  ногу
издеваться:  издеваются
техника:  техники
блистать:  блистал
разум:  разуме
создатель:  создателя создатели
платный:  платных
сайтик:  сайтик
шагать:  шагали
частность:  частности
евгений:  евгений
подслушивать:  подслушивать
подходящий:  подходящий
время:  временем
прелесть:  прелестями
чёткий:  четкому
захотеться:  захотелось
общаться:  общаться
состояние:  состояние
неужели:  неужели
чудо:  чудес
вражеский:  вражеской
самостоятельно:  самостоятельно
кошкин:  кошкин
опытный:  опытного
привычный:  привычный
эфтаназия:  эфтаназии
акаунт:  акаунт
ошибочно:  ошибочно
аккаунтаудалить:  аккаунтаудалить
дубль:  дубль
аккаунтудаление:  аккаунтудаление
блогновое:  блогновое
проголосовать:  проголосуют
приходиться:  приходится
переходить:  переходить
справедливый:  справедливым
появляться:  появляются
обсуждать:  обсуждали
рубрика:  рубрики
зваться:  зовутся
смит:  смит
форум:  форума
группыфорум:  группыфорум
юридический:  юридическая
навсегда:  навсегда
крупный:  крупных
поздно:  поздно
составлять:  составляли
сообществасоциальныесетиюрист:  сообществасоциальныесетиюристы
наделяев:  наделяев
кирилл:  кирилл
юрист:  юристов
сен:  сен
держатель:  держателям
хабриэль:  хабриэлю
опустить:  опустим
нету:  нету
хабриэлла:  хабриэллы
хабриэльхабриэлла:  хабриэльхабриэлла
команда:  команды команда
англоязычный:  англоязычного
яндексрупоискблокнотиктрафикдорыоптимист:  яндексрупоискблокнотиктрафикдорыоптимист
всерьёз:  всерьез
мутный:  мутною
мастер:  мастерам мастера
стенание:  стенаний
выдача:  выдачи
дорвей:  дорвеи дорвеями
весело:  весело
начало:  начале
элитный:  элитный
спрятаться:  спрячешься
конверт:  конверта
стоить:  стоит
выкатить:  выкатить
оптимист:  оптимиста оптимист
рассматривать:  рассматривать
подсесть:  подсели
клик:  клика клики
рупоиск:  рупоиск рупоиска рупоисков
поделать:  поделаешь
непонятно:  непонятно
блокнотик:  блокнотиков блокнотик блокнотика
тёмный:  темной
потечь:  потекли
договориться:  договориться
дружеский:  дружеские
весомый:  весомые
горячо:  горячо
сотня:  сотни
игла:  иглу
нигде:  нигде
вебальт:  вебальты
ребята:  ребят ребята
река:  рекою
предоставить:  предоставить
рыдать:  рыдают
стёб:  стеба
значительный:  значительное
заявление:  заявления
наносить:  наносят
костяк:  костяк
дорвейный:  дорвейного
игра:  игры
удар:  удар
забанить:  забанил
аргумент:  аргументы
смелый:  смелый
симметричный:  симметричного
жертва:  жертву
ужесточать:  ужесточает
громко:  громко
предать:  преданные
ответный:  ответный ответных
многое:  многое
партнёрство:  партнерства
отнекиваться:  отнекивался
тестирование:  тестирования
слезть:  слезут
жест:  жест
дорвейщик:  дорвейщиками
принести:  принести
отчаянно:  отчаянно
магазин:  магазинов
учитывать:  учитывая
фид:  фид
любим:  любим
переход:  переходе
дора:  доры
логично:  логично
подсчёт:  подсчете
явный:  явные
изменять:  изменяющего
корелировать:  корелировать
многочислить:  многочислены
важно:  важно
флеймера:  флеймеры
средний:  средний
топ:  топ
ровно:  ровно
понимать:  понимает
внимание:  внимание
уменьшаться:  уменьшается
логичный:  логичным
считаться:  считающийся
спорный:  спорно
подняться:  подняться
влиять:  влияет
практика:  практику
игорь:  игорю
связанный:  связанной
идеал:  идеале
шаг:  шагом
поднять:  поднять
уменьшить:  уменьшить
балл:  баллы баллов
оправдать:  оправдала
сверхпопулярный:  сверхпопулярный
метод:  методы
поднимать:  поднимать
величина:  величину
рейтинговый:  рейтинговая
опускать:  опускать
мастдать:  мастдай
зависимый:  зависим
обратить:  обратили
единица:  единицу
увеличиваться:  увеличивается
хабравойна:  хабравойны
изменение:  изменения
новичок:  новички
спустя:  спустя
мотолог:  мотолога
день:  дней
вес:  вес
катаклизм:  катаклизм
кармахабрахабра:  кармахабрахабр
кармограф:  кармографе
редактировать:  редактировать
вукс:  вукс
опечатка:  опечаткам
мелочь:  мелочь
татьяна:  татьяна
никак:  никак
банальный:  банальные
бывать:  бывают
корректор:  корректором
профайл:  профайла
параллельный:  параллельные
сумма:  сумму
рассмотрение:  рассмотрения
течение:  течение
кармический:  кармической
мах:  махом
выдавать:  выдавать
калька:  калька
бессмысленность:  бессмысленности
обкатать:  обкатанной
зависеть:  зависящим
скрывать:  скрывать
класс:  класс
копилка:  копилку
отменить:  отменить
орфография:  орфография
озадачить:  озадачил
бал:  бал
хабрахаброшибкирейтинг:  хабрахаброшибкирейтинг
адрес:  адрес
весьма:  весьма
фёдор:  федор
пожалуй:  пожалуй
править:  править
согласно:  согласно
бывший:  бывшего бывший
кармаграф:  кармаграф
июн:  июн
бурмистров:  бурмистрова
дорабатываться:  дорабатываться
ура:  ура
позыв:  позывам
снять:  сняли
смирнов:  смирнов
некрасиво:  некрасиво
неудобно:  неудобно
битый:  битую
видно:  видно
относиться:  относится
