похожий:  похожие
использоваться:  используется
тэг:  тэги
июл:  июл
хороший:  лучшие
комментарий:  комментарии
профиль:  профиль
история:  истории
дзен:  дзен
тег:  тег теги
старый:  старую
язык:  языке язык языка
мина:  мин
меню:  меню
прочтение:  прочтение
метка:  меток
поддержка:  поддержка
таг:  таг таги
технический:  техническая
исправить:  исправите
настройка:  настройка
хабра:  хабре хабр
версия:  версию
рейтинг:  рейтинг
обозначение:  обозначения
количество:  количество
хаба:  хабы
википедия:  википедию
сутки:  сутки
смотреть:  см
вернуться:  вернуться
добавить:  добавить
русский:  русском
поиск:  поиск
пользователь:  пользователь
просмотр:  просмотров
владислав:  владислав
яндекс:  яндекс
использовать:  использовать
публикация:  публикации
лингвый:  лингво
карма:  карма
закладка:  закладки
обновить:  обновить
семён:  семенов
вариант:  вариант
хабрахаброшибкитег:  хабрахаброшибкитеги
слово:  слово
