похожий:  похожие
чекбокс:  чекбокс
июл:  июл
хороший:  лучшие
титов:  титов
комментарий:  комментарии
профиль:  профиль
история:  истории
дзен:  дзен
логин:  логине
самопроизвольно:  самопроизвольно
старый:  старую
язык:  язык языка
мина:  мин
меню:  меню
прочтение:  прочтение
уверенный:  уверен
поддержка:  поддержка
технический:  техническая
настройка:  настройка
версия:  версию
рейтинг:  рейтинг
количество:  количество
хаба:  хабы
сутки:  сутки
вернуться:  вернуться
смена:  смене
добавить:  добавить
павел:  павел
поиск:  поиск
пользователь:  пользователь
просмотр:  просмотров
несмотря:  несмотря
яндекс:  яндекс
ощущение:  ощущение
разлогинивание:  разлогинивание
хабра:  хабр
возможно:  возможно
публикация:  публикации
самопроизвольный:  самопроизвольное
происходить:  происходит
карма:  карма
закладка:  закладки
тег:  теги
обновить:  обновить
включить:  включен
