похожий:  похожие
хороший:  лучшие
мочь:  могу
комментарий:  комментарии
тайландобломрепортаж:  тайландобломрепортаж
профиль:  профиль
главный:  главный
обломать:  обломать
интернет:  интернета
история:  истории
дзен:  дзен
признак:  признаки
наткнуться:  наткнусь
старый:  старую
должный:  должны
хабра:  хабра хабр
язык:  язык языка
мина:  мин
прочтение:  прочтение
меню:  меню
поддержка:  поддержка
технический:  техническая
уезжать:  уезжаю
голос:  голосов
настройка:  настройка
корреспондент:  корреспондент
идея:  идеи
версия:  версию
рейтинг:  рейтинг
таиланд:  тайланда тайланд
авг:  авг
количество:  количество
хаба:  хабы
тема:  тему
дмитрий:  дмитрий
сутки:  сутки
вернуться:  вернуться
добавить:  добавить
поиск:  поиск
пользователь:  пользователь
просмотр:  просмотров
отдых:  отдых
привезти:  привезти
критерий:  критерий
обещать:  обещаю
яндекс:  яндекс
сделать:  сделаю
экскюзивный:  экскюзивно
коллажик:  коллажик
ульянов:  ульянов
фотографировать:  фотографировать
бангкок:  бангкоке
карма:  карма
публикация:  публикации
присутствие:  присутствия
друг:  друзья
тег:  теги
обновить:  обновить
закладка:  закладки
патайя:  патайе
