тэг:  тэги
побочный:  побочный
боль:  боли
комментарий:  комментарии
сычёв:  сычева
профиль:  профиль
семинар:  семинаров
провайдер:  провайдеров провайдеры провайдера
первый:  первую
очередь:  очередь
функция:  функция
революция:  революцию
дзен:  дзен
выполняться:  выполняется
интернет:  интернет интернете
видеть:  видит
меню:  меню
прочтение:  прочтение
поддержка:  поддержка
содержимое:  содержимое
платёжный:  платежную платежного платежных
находиться:  находится
голос:  голосов
созреть:  созрела
тематический:  тематических
специальный:  специальная
цена:  ценой
версия:  версию
рейтинг:  рейтинг
напомнить:  напомнило
авг:  авг
код:  код
генерировать:  генерируемый
хаба:  хабы
дмитрий:  дмитрий
концепция:  концепцию
скачать:  скачанной скачать скачайте
сутки:  сутки
вернуться:  вернуться
хотеть:  хочет хочу
один:  одном одну
реальный:  реальных
пользоваться:  пользоваться
поиск:  поиск
работа:  работы
утяжеляться:  утяжеляется
колонка:  колонок
контент:  контента контент
недра:  недрах
соответсвенный:  соответсвенно
красота:  красоты красота
существующий:  существующих
решить:  решило
приблизительно:  приблизительно
использовать:  использовать
средство:  средств средство
рассказать:  рассказать
блогер:  блоггеров
вывод:  выводом
мегабайтный:  мегабайтная мегабайтный
продажа:  продаже
охота:  охота
держать:  держать
расцвет:  расцвет
обновить:  обновить
закладка:  закладки
легко:  легко
мегабайт:  мегабайты
зарастать:  зарастает
деталь:  деталях
система:  система системах системы систему систем
файл:  файлов файлу
сухой:  сухой
произвести:  произвела
принцип:  принципу принципа
хороший:  лучшие
настоящий:  настоящая
они:  ним
нереализуемый:  нереализуема
красивый:  красивый
придумать:  придумал
рассматриваться:  рассматривалась
история:  истории
уста:  уст
пройти:  прошло
некий:  некую некая
никто:  никто
пихтый:  пихто
старый:  старую
рассмотреть:  рассмотреть
язык:  язык языка
отсутствовать:  отсутствует
маленький:  мал
множество:  множество
проект:  проекты
тот:  той
пример:  примера
пользователь:  пользователя пользователь пользователи
сторона:  стороны
количество:  количество
становиться:  становится
вовремя:  вовремя
общеизвестный:  общеизвестны
разный:  разного
идти:  шла
новый:  новую
недостаток:  недостатки
услышать:  услышал
валериевич:  валерьевича
эффект:  эффект
внедрение:  внедрение
сфера:  сфере сферу
ошибаться:  ошибаться
хабра:  хабр
знать:  знаю
сравнение:  сравнению
значимый:  значимой
трафик:  трафик
представить:  представить
несоизмеримый:  несоизмеримо
доступ:  доступе доступа
наступить:  наступил
текст:  текстов
народный:  народная
популярный:  популярными
выгодно:  выгодно
странный:  странной
проблема:  проблемы
оценить:  оценить
идеальный:  идеальна идеальную
получение:  получения
просить:  прошу
утопичный:  утопична
схема:  схеме схемы
подключить:  подключены
платёж:  платежи
автор:  авторов авторами автор автора
выплачивать:  выплачивая
использование:  использовании использования
рядовой:  рядового
искусственно:  искусственно
распространённость:  распространенность
ваш:  вашей
инструмент:  инструмента инструмент
оплата:  оплатой оплаты
просмотр:  просмотров
ввод:  вводом
яндекс:  яндекс
дело:  дело
ценить:  ценю
который:  которую которым
любой:  любой
информация:  информации
производить:  производят
пора:  поры
замысел:  замыслу
публикация:  публикации
ограниченный:  ограниченную
считать:  считать
тег:  теги
качество:  качестве
внутренний:  внутренняя
задача:  задача
познакомиться:  познакомились
цифровой:  цифрового
взаимотребленный:  взаимотребленные
похожий:  похожие
мочь:  могу
счёт:  счета
отдавать:  отдаю
картинка:  картинок
существовать:  существует
мина:  мин
происходить:  происходило
технический:  техническая
выложить:  выложил
чулан:  чулан
простой:  проста
обсуждение:  обсуждение
зачётный:  зачетному
настройка:  настройка
применение:  применения
среди:  среди
файлик:  файлик
решаться:  решался
свободный:  свободном
точный:  точного
либо:  либо
добавить:  добавить
денежка:  денежка
сложность:  сложность
остаток:  остаток
оплачивать:  оплачивать
вопрос:  вопрос вопросов
иметь:  имеет
программный:  программный
универсальный:  универсального универсальное
тропа:  тропа
малый:  малая
вещь:  вещью
карма:  карма
условие:  условиях
сразу:  сразу
отчёт:  отчет
разместить:  размещенных
получить:  получить
сергей:  сергея
идея:  идеях
относительный:  относительная
