похожий:  похожие
явка:  явки
хороший:  лучшие
рассказать:  расскажите
комментарий:  комментарии
профиль:  профиль
продажа:  продажа продаже
слышать:  слышал
история:  истории
дзен:  дзен
старый:  старую
цифра:  цифры
интернет:  интернет
зарабатывать:  зарабатывать
язык:  язык языка
мина:  мин
меню:  меню
прочтение:  прочтение
пароль:  пароли
поддержка:  поддержка
технический:  техническая
чулан:  чулан
голос:  голосов
дрогановый:  дроганов
траффик:  траффика
условие:  условия
настройка:  настройка
версия:  версию
рейтинг:  рейтинг
количество:  количество
авг:  авг
хаба:  хабы
сутки:  сутки
трафик:  трафика трафик
вернуться:  вернуться
добавить:  добавить
поиск:  поиск
спец:  спецам
просмотр:  просмотров
проект:  проект
платить:  платил
сергей:  сергей
пользователь:  пользователь
яндекс:  яндекс
вопрос:  вопрос
профит:  профит
хабра:  хабр
мб:  мб
мастерхост:  мастерхост
публикация:  публикации
карма:  карма
вебмастер:  вебмастерам
закладка:  закладки
россия:  россии
обновить:  обновить
тег:  теги
