старикан:  стариканов
победитель:  победители
вирусный:  вирусный
ролик:  ролики
блогостратегия:  блогостратегии
переехать:  переехать
профиль:  профиль
напиток:  напиток
собираться:  собирается
комментарий:  комментарии
дзен:  дзен
талант:  талантом
подробно:  подробно
число:  числе
стратегически:  стратегически
статья:  статью
меню:  меню
прочтение:  прочтение
баннер:  баннеры
социальный:  социальная социальную социальных
безошибочный:  безошибочной
предполагаться:  предполагается предполагалось
поддержка:  поддержка
находиться:  находится
голос:  голосов
сообщество:  сообщества сообществ
непонравиться:  непонравившихся
количество:  количестве количество
новый:  новым
кингдом:  кингдом
рейтинг:  рейтинг
версия:  версию
френд:  френдами
авг:  авг
хаба:  хабы
дмитрий:  дмитрий
майами:  майами
путешествовать:  путешествуют
умно:  умно
первый:  первое
сутки:  сутки
позиция:  позиции
подобный:  подобные
запускать:  запускает
направлять:  направляющие
хотеть:  хочет
вернуться:  вернуться
поиск:  поиск
некролог:  некрологов
говорить:  говорят
париж:  париж
сеть:  сеть сетях
тейлор:  тейлор
повторять:  повторяет
данные:  данным
остальной:  остальном
получать:  получает
печатный:  печатных
использовать:  использовать
неограниченный:  неограниченном
участник:  участников
планета:  планете
закладка:  закладки
аккаунт:  аккаунты
обновить:  обновить
описывать:  описывать
будущий:  будущих
бренд:  брендов
клип:  клипы
хороший:  лучшие
история:  истории
помогать:  помогает
фокусировка:  фокусировки
социально:  социально
старый:  старую
юноша:  юношей
привлечь:  привлекла
таргетировать:  таргетировать
язык:  язык языка
баннерный:  баннерные
иллюстрация:  иллюстрация
блог:  блогов блогах
социум:  социум
голосование:  голосованием
идти:  идут
знакомить:  знакомящих
например:  например
видеосюжет:  видеосюжет
кастинг:  кастинга
приближаться:  приближающихся
занимать:  занимает
популярный:  популярных
создавать:  создавая
обзор:  обзор
маркетолог:  маркетологи
интерес:  интересов интересы
имейл:  имейл
интерактивный:  интерактивное
менять:  меняют
кингдон:  кингдон
завести:  завести
стать:  станет станут
аккуатный:  аккуатно
проект:  проект проекта
предлагаться:  предлагаются
чужой:  чужих
интернет:  интернете
блогосфера:  блогосфера блогосферой
бесполезно:  бесполезно
начинаться:  начинается
основной:  основной
вещь:  вещи
короткий:  короткий
комьюнити:  комьюнити
местный:  местных
хабра:  хабр
вид:  вид
трафик:  трафику
выбирать:  выбирать
рекламодатель:  рекламодателей рекламодателями
собрать:  собрать
беглый:  беглый
американский:  американские американских
видео:  видео
главный:  главные
мечта:  мечта мечты
благополучие:  благополучие
девушка:  девушек
правильно:  правильно
партнёр:  партнеров
размещение:  размещение
разсылай:  разсылая
продвижение:  продвижения
дело:  дела
перспективный:  перспективнейшим
правильный:  правильные
любовь:  любовь
один:  одна
точечный:  точечной
узко:  узко
главное:  главное
пенсия:  пенсии
строить:  строить
пенсионер:  пенсионеров пенсионеры
контекстный:  контекстное
монстр:  монстров
трендсеттер:  трендсеттеров
вместе:  вместе
брендирование:  брендировании
взамен:  взамен
самый:  самых самое самую
присылать:  присылает присылать
пользователь:  пользователь
просмотр:  просмотров
любой:  любого
прочитать:  прочитанного
яндекс:  яндекс
голосовать:  голосуют
издание:  изданиях
колонка:  колонке
реклама:  рекламы
развитие:  развития
осуществить:  осуществить
публикация:  публикации
основатель:  основатель
бесплатный:  бесплатный
подходить:  подходит
юзер:  юзеры
тег:  теги
медиа:  медиа
считать:  считают считает
качество:  качестве
известный:  известные
задача:  задача
исключать:  исключают
поскольку:  поскольку
стадия:  стадии
похожий:  похожие
желать:  желающий
контент:  контент
сфокусировать:  сфокусированное
пиар:  пиар
восхищаться:  восхищается
остаться:  останется
мина:  мин
стремиться:  стремиться
продвигать:  продвигать
спонсор:  спонсор
чулан:  чулан
энергетический:  энергетическим
сентябрь:  сентябре
место:  места место
настройка:  настройка
технический:  техническая
база:  базу
момент:  момента
полный:  полную
совпадение:  совпадении
жительство:  жительства
внутри:  внутри
площадка:  площадки
добавить:  добавить
полететь:  полетят
выбрать:  выбрать
джефф:  джефф
благополучный:  благополучных
сетевой:  сетевой
практический:  практическом
финансы:  финансы
красота:  красотой
сообщение:  сообщения
ульянов:  ульянов
воплощение:  воплощении
карма:  карма
возможность:  возможность
брендировать:  брендировать
необходимо:  необходимо
замечательный:  замечательно
стандартный:  стандартные
