похожий:  похожие
ответ:  ответ
интересно:  интересно
хороший:  лучшие
комментарий:  комментарии
профиль:  профиль
история:  истории
дзен:  дзен
старый:  старую
услышать:  услышать
язык:  язык языка
юридический:  юридическая
мина:  мин
навсегда:  навсегда
меню:  меню
мнение:  мнение
поддержка:  поддержка
прочтение:  прочтение
технический:  техническая
чулан:  чулан
письмо:  письма
голос:  голосов
настройка:  настройка
версия:  версию
рейтинг:  рейтинг
крупный:  крупных
количество:  количество
хаба:  хабы
сутки:  сутки
вернуться:  вернуться
подобный:  подобные
добавить:  добавить
поздно:  поздно
поиск:  поиск
пользователь:  пользователь
просмотр:  просмотров
яндекс:  яндекс
составлять:  составляющая
приходить:  приходить
сообществасоциальныесетиюрист:  сообществасоциальныесетиюристы
наделяев:  наделяев
хабра:  хабр
комментировать:  комментировать
публикация:  публикации
карма:  карма
кирилл:  кирилл
юрист:  юристов
закладка:  закладки
тег:  теги
обновить:  обновить
сен:  сен
держатель:  держателям
сообщество:  сообществ
получить:  получить
