похожий:  похожие
почта:  почтой
июл:  июл
приходить:  приходят
хороший:  лучшие
комментарий:  комментарии
профиль:  профиль
история:  истории
дзен:  дзен
старый:  старую
ответ:  ответы
хабрахабрхабратредпочта:  хабрахабрхабратредпочта
язык:  язык языка
мина:  мин
иванов:  иванов
меню:  меню
прочтение:  прочтение
хабратредстартер:  хабратредстартеру
поддержка:  поддержка
технический:  техническая
голос:  голосов
настройка:  настройка
версия:  версию
рейтинг:  рейтинг
количество:  количество
хаба:  хабы
пост:  пост
сутки:  сутки
роман:  роман
вернуться:  вернуться
добавить:  добавить
поиск:  поиск
пользователь:  пользователь
просмотр:  просмотров
яндекс:  яндекс
группа:  группах
хабра:  хабр
корневой:  корневой
публикация:  публикации
карма:  карма
закладка:  закладки
тег:  теги
обновить:  обновить
хабратред:  хабратреда
место:  местах
